"",Team,Games,Wins,Draws,Losses,Goals,Goals_Against,GD,Points
0,Manchester City,38,28,7,3,96,34,62,91
1,Arsenal,38,28,5,5,91,29,62,89
2,Liverpool,38,24,10,4,86,41,45,82
3,Aston Villa,38,20,8,10,76,61,15,68
4,Tottenham,38,20,6,12,74,61,13,66
5,Chelsea,38,18,9,11,77,63,14,63
6,Manchester United,38,18,6,14,57,58,-1,60
7,Newcastle United,38,18,6,14,85,62,23,60
8,West Ham,38,14,10,14,60,74,-14,52
9,Crystal Palace,38,13,10,15,57,58,-1,49
10,Everton,38,13,9,16,40,51,-11,48
11,Brighton,38,12,12,14,55,62,-7,48
12,Bournemouth,38,13,9,16,54,67,-13,48
13,Fulham,38,13,8,17,55,61,-6,47
14,Wolverhampton,38,13,7,18,50,65,-15,46
15,Brentford,38,10,9,19,56,65,-9,39
16,Nottingham Forest,38,9,9,20,49,67,-18,36
17,Luton Town,38,6,8,24,52,85,-33,26
18,Burnley,38,5,9,24,41,78,-37,24
19,Sheffield,38,3,7,28,35,104,-69,16
